10
10
5:5:0:1:0
5:6:0:1:0
5:7:0:1:0
5:8:0:1:0
5:9:0:1:0
4:5:0:1:0
4:6:0:1:0
4:7:0:1:0
4:8:0:1:0
4:9:0:1:0
3:5:0:1:0
3:6:0:1:0
3:7:0:1:0
3:8:0:1:0
3:9:0:1:0
2:5:0:1:0
2:6:0:1:0
2:7:0:1:0
2:8:0:1:0
2:9:0:1:0
1:5:0:1:0
1:6:0:1:0
1:7:0:1:0
1:8:1:1:0
1:9:1:1:0
